x,x,x,x,x,x,x,x,x,x,x,x
x,x,x,x,x,x,x,x,x,x,x,x
x,x,x,x,x,x,x,x,x,x,x,x
x,x,x,,,,x,,,E,x,x
x,x,x,,,,,♟1,x,,x,x
x,x,x,,,,x,,,,x,x
x,x,x,x,,x,x,x,x,x,x,x
x,x,x,,,,x,x,x,x,x,x
x,x,x,,x,,x,x,x,x,x,x
x,x,x,S,,,x,x,x,x,x,x
x,x,x,x,x,x,x,x,x,x,x,x
x,x,x,x,x,x,x,x,x,x,x,x
x,x,x,x,x,x,x,x,x,x,x,x