x,x,x,x,x,x,x,x,x,x,x,x
x,,,,,,,,,,,x
x,,,,,,,,,,,x
x,,,,,,E,,,,,x
x,,,,,,,,,,,x
x,,,,,,,,,,,x
x,,,,,,,,,,,x
x,,,,,b1,,,,,,x
x,,,,,,,,,,,x
x,,,,,,,,,,,x
x,S,x,x,x,x,x,x,x,x,x,x
x,x,x,x,x,x,x,x,x,x,x,x