x,x,x,x,x,x,x,x,x,x,x,x
x,,,p1,E,,,BOMB,,,p1,x
x,,x,x,,x,x,,x,x,,x
x,,x,x,,x,x,,x,x,,x
x,,,p1,BOMB,,,BOMB,,,p1,x
x,,x,x,,x,x,,x,x,,x
x,,x,x,,x,x,,x,x,,x
x,,,,BOMB,,,BOMB,,,p1,x
x,,x,x,,x,x,,x,x,,x
x,,x,x,,x,x,,x,x,,x
x,,,p1,BOMB,,,BOMB,,,p1,x
x,,x,x,,x,x,,x,x,,x
x,,x,x,,x,x,,x,x,,x
x,S,,,,,,,,,,x
x,x,x,x,x,x,x,x,x,x,x,x
x,x,x,x,x,x,x,x,x,x,x,x