x,x,x,x,,,,x,x,x,x
x,x,,,,,,,,x,x
x,x,,x,,,,x,,x,x
x,x,,x,,,,x,,x,x
x,x,,x,,,,x,,x,x
x,x,,x,,,,x,,x,x
x,x,,x,,,,x,,x,x
x,x,p2,x,,,,x,p2,x,x
x,x,x,x,,,,x,x,x,x
x,x,x,x,x,s,x,x,x,x,x
x,x,x,x,x,x,x,x,x,x,x
x,x,x,x,x,x,x,x,x,x,x