x,x,x,x,x,x,x,x,x,x,x,x
x,,,,,,pk,,,,,x
x,,x,x,x,x,x,x,x,x,,x
x,,x,,,x,x,,,x,,x
x,,x,p5,x,x,x,x,p4,x,,x
x,,x,x,x,p1,E,x,x,x,,x
x,,x,x,x,,,x,x,x,,x
x,,x,p2,x,x,x,x,p3,x,,x
x,,x,,,x,x,,,x,,x
x,,x,x,x,x,x,x,x,x,,x
x,,,,,pk,S,,,,,x
x,x,x,x,x,x,x,x,x,x,x,x