x,x,x,x,x
x,,,,x
x,,E,,x
x,,,,x
x,x,Door,x,x
x,,,,x
x,,S,,x
x,,UNLOCK,,x
x,x,x,x,x