x,x,x,x,x,x,x,x,x,x,x,x
x,x,x,x,x,E,x,x,x,x,x,x
x,x,x,x,x,x,pk,x,x,x,x,x
x,x,x,x,,x,,x,x,x,x,x
x,x,x,x,x,x,,x,x,x,x,x
x,r1,,x,x,x,,x,x,x,x,x
x,x,,,x,x,pr,x,x,x,x,x
x,x,x,,,,,,,,,x
x,x,x,,,,,,,,,x
x,x,x,,,,,,,,,x
x,x,x,,,,,,,,pb,x
x,x,x,,x,,,,S,,,x
x,x,x,x,x,x,x,x,x,x,x,x