x,x,x,x,x,x,x,x,x
x,♟8,,♟7,,♟6,,x,x
x,,♟9,,,,♟5,x,x
x,♟2,,,E,,,x,x
x,,,,,,♟4,x,x
x,♟1,,,,♟3,,x,x
x,x,x,,,x,x,x,x