x,x,x,x,x,x,x,x,x,x,x,x,x,x,x,x,x
x,x,x,x,x,x,x,x,x,x,x,x,x,x,x,x,x
x,x,x,x,x,x,x,x,x,x,x,x,x,x,x,x,x
x,x,x,x,x,x,x,x,x,x,x,x,x,x,x,x,x
x,x,x,x,x,x,x,x,,,♟2,x,x,x,x,x,x
x,x,x,x,,x,x,x,,,,x,x,x,,x,x
x,x,x,,x,,x,x,♟1,,,x,x,,x,,x
x,x,♗,x,x,x,,,x,x,x,,,x,x,x,x
x,x,x,x,x,x,pb,,x,x,x,,,,♟2,x,x
x,x,x,x,x,,,x,,x,,x,,,,x,x
x,x,x,x,x,s,e,x,x,,x,x,♟1,,,x,x
x,x,x,x,x,x,x,x,x,x,x,x,x,x,x,x,x