x,x,x,x,x,x,x,x,x,x,x,x
x,,,,,,,,,,,x
x,,x,x,x,x,x,x,x,x,,x
x,,x,r1,,,,,,x,,x
x,,x,,x,x,x,x,,x,,x
x,,x,,x,,E,x,,x,,x
x,,x,,x,,,x,,x,,x
x,,x,,x,x,x,x,,x,,x
x,,x,r2,,,,,,x,,x
x,,x,x,x,x,x,x,x,x,,x
x,,,,,pk,S,,,,,x
x,x,x,x,x,x,x,x,x,x,x,x