x,x,x,x,x,x,x,x,x
x,♟8,,♟7,,♟6,,x,x
x,,,,,,♟5,x,x
x,,,,E,,,x,x
x,,♟9,,,,♟4,x,x
x,♟1,,♟2,,♟3,,x,x
x,x,x,,,x,x,x,x