x,x,x,x,x,x,x,x,x,x,x,x
x,x,x,x,x,x,E,x,x,x,x,x
x,x,x,x,x,x,DOOR,x,x,x,x,x
x,x,,x,x,x,DOOR,x,,x,x,x
x,x,x,x,x,x,DOOR,x,x,x,,x
x,x,x,x,x,x,,x,x,x,x,x
x,x,x,x,x,x,DOOR,x,x,x,x,x
x,x,x,x,x,x,,x,x,x,x,x
x,x,x,x,,x,DOOR,x,x,,x,x
x,x,,x,x,x,DOOR,x,x,x,x,x
x,x,x,x,x,x,DOOR,x,x,x,x,x
x,x,x,x,x,x,,x,x,x,x,x
x,x,x,,x,x,DOOR,x,x,x,x,x
x,,x,x,x,x,,x,x,x,x,x
x,x,x,x,x,,,,x,x,,x
x,x,x,x,x,,UNLOCK,,x,x,x,x
x,x,x,x,x,,S,,x,x,x,x
x,x,x,x,x,x,x,x,x,x,x,x