x,x,x,x,x,x,x,x,x,x,x,x,x
x,,,,,,E,,,,,,x
x,,x,x,,x,x,x,,x,x,,x
x,,x,,x,x,x,x,x,,x,,x
x,,,x,,,♛,,,x,,,x
x,,x,,x,x,x,x,x,,x,,x
x,,x,,x,,♘,,x,,x,,x
x,,x,,x,x,x,x,x,,x,,x
x,,,x,,,,,,x,,,x
x,,x,,x,x,x,x,x,,x,,x
x,,x,x,pk,x,x,x,pk,x,x,,x
x,,,,,,S,,,,,,x
x,x,x,x,x,x,x,x,x,x,x,x,x