x,x,x,x,x,x,x,x,x,x,x,x
x,x,x,x,x,x,x,x,x,x,x,x
x,x,x,x,x,x,x,x,x,x,x,x
x,x,x,,E,,x,,,,x,x
x,x,x,,,,,,pp,,x,x
x,x,x,,,,x,,,,x,x
x,x,x,x,x,x,,x,x,x,x,x
x,x,x,,,,x,,,,x,x
x,x,x,,S,,,,pb,,x,x
x,x,x,,,,x,,,,x,x
x,x,x,x,x,x,x,x,x,x,x,x
x,x,x,x,x,x,x,x,x,x,x,x
x,x,x,x,x,x,x,x,x,x,x,x