x,x,x,x,x,x,x,x,x,x,x,x
x,UNLOCK,,,,,,,,,,x
x,,x,x,x,x,x,x,x,x,,x
x,,x,,,,,,,x,,x
x,,x,,x,x,x,x,,x,,x
x,,DOOR,,DOOR,,E,x,,x,,x
x,,x,,x,,x,x,,x,,x
x,,x,,x,♘1,,,,x,,x
x,,x,,x,x,x,x,x,x,,x
x,,x,,,,,,,,,x
x,S,x,x,x,x,x,x,x,x,x,x
x,x,x,x,x,x,x,x,x,x,x,x