x,x,x,x,,x,x,,x,,x,,,x,,x,,x,x,x,x
x,x,x,,x,x,,x,x,x,,x,,x,,x,x,,,x,x
x,x,,,,pk,,x,pk,,,x,pk,,,pk,,x,x,x,x
x,x,x,,,,,,,,,,,,,,,,x,x,x
x,x,x,x,,,,,,,,,,,,,,x,,x,x
x,x,,x,x,,,,,,s,,,,,,x,x,x,x,x
x,x,x,x,x,x,,,,,,,,,,x,x,,x,x,x
x,x,x,x,x,x,x,,x,x,,x,x,,x,x,x,x,x,x,x
x,x,x,x,x,x,x,x,x,x,x,x,x,x,x,x,x,x,x,x,x