x,x,x,x,x,x,x,pp,x,x,x,x,x,x,x
x,x,x,x,x,x,,x,,x,x,x,x,x,x
x,x,x,x,x,,x,x,x,,x,x,x,x,x
x,x,x,x,,x,x,x,x,x,,x,x,x,x
x,x,x,,x,,x,x,x,,x,,x,x,x
x,x,,x,x,x,,x,,x,x,x,,x,x
x,,x,x,x,x,x,,x,x,x,x,x,,x
x,x,,x,x,x,,x,,x,x,x,,x,x
x,x,x,,x,,x,x,x,,x,,x,x,x
x,x,x,x,,x,x,x,x,x,,x,x,x,x
x,x,x,x,x,pb,x,x,x,pb,x,x,x,x,x